12000000011000000021
22000000011000000022
00000000011000000000
00000000011000000000
00000000011000000000
00000000011000000000
00000000011000000000
00000000000000000000
00000000000000000000
22222220000002222222
22222220000002222222
00000000000000000000
00000000000000000000
00000000011000000000
00000000011000000000
00000000011000000000
00000000011000000000
00000000011000000000
22000000011000000022
12000000011000000021
