00000000000000000000
00110000000000002200
01100000000000000220
01000000000000000020
00000000000000000000
00000000000000000000
00000000000000000000
00000000000000000000
00000000222200000000
00000000000000000000
00000000000000000000
00000000222200000000
00000000000000000000
00000000000000000000
00000000000000000000
00000000000000000000
02000000000000000010
02200000000000000110
00220000000000001100
00000000000000000000
