00020000000200000000
00020000000200000000
00020000000200000000
00020000000200000000
00020000000200000000
00020000000200000000
00020000000200000000
00020000000200000000
00020002000200020000
00020002000200020000
00020002000200020000
00020002000200020000
00000002000000020000
00000002000000020000
00000002000000020000
00000002000000020000
00000002000000020000
00000002000000020000
00000002000000020000
00000002000000020000
