00000000000000000000
00000000000000000000
00000000000000000000
00002222222222220000
00002000000000020000
00002000000000020000
00002000000000020000
00002000000000020000
00000000100100000000
00000000100100000000
00000000100100000000
00000000100100000000
00002000000000020000
00002000000000020000
00002000000000020000
00002000000000020000
00002222222222220000
00000000000000000000
00000000000000000000
00000000000000000000
